{
    "bricks" : [
        {
            "w": 80,
            "h": 30,
            "x": 40,
            "y": 100
        },
        {
            "w": 80,
            "h": 30,
            "x": 124,
            "y": 100
        },
        {
            "w": 80,
            "h": 30,
            "x": 208,
            "y": 100
        },
        {
            "w": 80,
            "h": 30,
            "x": 292,
            "y": 100
        },
        {
            "w": 80,
            "h": 30,
            "x": 376,
            "y": 100
        },
        {
            "w": 80,
            "h": 30,
            "x": 460,
            "y": 100
        }
    ]
}